1111111111111111111111111111111111
1ER000R00000000C00000C000000000001
101001010R10000R101001000000010101
10100100101010100010010000000101R1
1P0000000C00C00000RR00000000000CC1
1111111111111111111111111111111111