11111111
100C0001
10000001
1000P001
1000E001
10000111
10010101
11111111