1111111111111111111111111111111111
1ER000R00000000C00000C000000000001
101001010R10000R101001000000010101
1010010010101010001001000000010111
1P0000000C00C00000RR0000000000R101
1111111111111111111111111111111111