11111111
100C0001
10000001
100E0001
1003E001
10000111
100101C1
1111111